   0                   1    
   0 1 2 3 4 5 6 7 8 9 0 1 2
00 4 # # # # # # # # # # # 1
 1 # . . . W # . # . # . . #
 2 # . # # # # # # . # . . #
 3 # # # . . # . # . # L . #
 4 # . # . . # . # . # # # #
 5 # . # # . # . # . # . . #
 6 # . . # . # M # . # . . #
 7 # . . # . # . # . # # . #
 8 # # # # . # . # . . # . #
 9 # . S # . # . # . . # # #
10 # . . # . # # # # # # . #
 1 # . . # . # . # D . . . #
 2 2 # # # # # # # # # # # 3